1 13 31
###############################
#p     ** * 2  *   *  * * *   #
# # # #*# # #*#*# # # #*#*#*# #
# x *     ***  *      *   * * #
# # # # # #*# # #*#*# # # # #*#
#f   1  b    **s *  *  1     1#
# # # # # # # # # #*#1#*# # # #
#*  *   2  *  *      *        #
# # # # #*# # # #*#*# # # # # #
#*    **  *       *           #
# #*# # # # # # #*# # # # # # #
#           *1  *  *          #
###############################