1 13 31
###############################
#p     ** * 2  *   *  * * *   #
# # # #*# # #*#*# # # #*#*#*# #
# x *     ***  *      *   * * #
# # # # # #*# # #*#*# # # # #*#
#f   1  b    **f *  *         #
# # # # # # # # # #*# #*# # # #
#*  *      *  *      *        #
# # # # #*# # # #*#*# # # # # #
#*    **  *       *           #
# #*# # # # # # #*# # # # # # #
#           *   *  *          #
###############################